#000#000#000#000#000#000#000#000#000#000#000#000#000#000#000#000#000#000#000#000#000#000#000#000#000#000#000#000#000#000#000#000#000#000#000#000#000#000#000#000#000#000#000#000#000#000#000#000#000#000#000#000#000#000#000#000#000#000#000#000#000#000#000#000#000#000#000#000#000#000#000#000#000#000#000#000#000#000#000#000#000#000#000#000#000#000#000#000#000#000#000#000#000#000#000#000#000#000#000#000#000
#000#000#000#000#000#000#000#000#000#000#000#000#000#000#000#000#000#000#000#000#000#000#000#000#000#000#000#000#000#000#000#000#000#000#000#000#000#000#000#000#000#000#000#000#000#000#000#000#000#000#000#000#000#000#000#000#000#000#000#eee#eee#000#000#000#000#000#000#000#000#000#000#000#000#000#000#000#000#000#000#000#000#000#000#000#000#000#000#000#000#000#000#000#000#000#000#000#000#000#000#000#000
#000#000#000#000#000#000#000#000#000#000#000#000#000#000#000#000#000#000#000#000#000#000#000#000#000#000#000#000#000#000#000#000#000#000#000#000#000#000#000#000#000#000#000#000#000#000#000#eee#eee#000#000#000#000#000#000#000#000#000#eee#eee#eee#eee#eee#000#000#000#eee#eee#000#000#000#000#000#000#000#000#000#000#000#000#000#000#000#000#000#000#000#000#000#000#000#000#000#000#000#000#000#000#000#000#000
#000#000#000#000#000#000#000#000#000#000#000#000#000#000#000#000#000#000#000#000#000#000#000#000#eee#eee#000#000#000#000#000#000#000#000#000#000#000#000#000#000#000#000#000#000#000#000#000#eee#eee#000#000#000#000#000#000#000#000#000#eee#ccd#ccd#eee#eee#000#000#000#eee#eee#000#000#000#000#000#000#000#000#000#000#000#000#000#000#000#000#000#000#000#000#000#000#000#000#000#000#000#000#000#000#000#000#000
#000#000#000#000#000#000#000#000#000#000#000#000#000#000#000#000#000#000#000#000#000#000#000#000#eee#eee#000#000#000#000#000#000#000#000#000#000#000#000#000#000#000#000#000#000#000#000#000#eee#eee#000#000#000#000#000#000#000#000#000#eee#ccd#ccd#eee#eee#000#000#000#eee#eee#000#000#000#000#000#000#000#000#000#000#000#000#000#000#000#000#000#000#000#000#000#000#000#000#000#000#000#000#000#000#000#000#000
#000#000#000#000#000#000#000#000#000#000#000#000#000#000#000#000#000#000#000#000#000#000#000#eee#eee#eee#000#000#000#000#000#000#000#000#000#000#000#000#000#000#000#000#000#000#000#000#eee#eee#eee#000#000#000#000#000#000#000#000#000#eee#ccd#ccd#eee#eee#000#000#eee#eee#eee#eee#000#000#000#000#000#000#000#000#000#000#000#000#000#000#000#000#000#000#000#000#000#000#000#000#000#000#000#000#000#000#000#000
#000#000#000#000#000#000#000#000#000#000#000#000#000#000#000#000#000#000#000#000#000#000#000#eee#ccd#eee#000#000#000#000#000#000#000#000#000#000#000#000#000#000#000#000#000#000#000#000#eee#ccd#eee#000#000#000#000#000#000#000#000#eee#eee#ccd#ccd#ccd#ccd#000#000#eee#ccd#ccd#eee#000#000#000#000#000#000#000#000#000#000#000#000#000#000#000#000#000#000#000#000#000#000#000#000#000#000#000#000#000#000#000#000
#000#000#000#000#000#000#000#000#000#000#000#000#000#000#000#000#000#000#000#000#000#000#000#eee#ccd#ccd#eee#000#000#000#000#000#000#000#000#000#000#000#000#000#000#000#eee#eee#eee#000#ccd#ccd#ccd#000#000#eee#eee#000#000#000#000#ccd#ccd#ccd#ccd#ccd#ccd#000#000#ccd#ccd#ccd#ccd#000#000#000#000#000#eee#eee#eee#000#000#000#000#000#000#000#000#000#000#000#000#000#000#000#000#000#000#000#000#000#000#000#000
#000#000#000#000#000#000#000#000#000#000#000#000#000#000#000#000#000#000#000#000#000#000#000#ccd#ccd#ccd#ccd#000#000#000#000#000#000#000#000#000#000#000#000#000#000#9ab#9ab#9ab#ccd#ccd#ccd#ccd#ccd#eee#eee#ccd#ccd#eee#000#000#000#ccd#ccd#ccd#ccd#ccd#ccd#000#ccd#ccd#ccd#ccd#ccd#000#000#000#eee#eee#eee#eee#eee#eee#000#000#eee#eee#eee#000#000#000#000#000#000#000#000#000#000#000#000#000#000#000#000#000#000
#000#000#000#000#000#000#000#000#000#000#000#000#000#000#000#000#000#000#000#000#000#000#000#ccd#ccd#ccd#ccd#000#000#000#000#000#000#000#000#000#000#000#000#000#000#000#000#9ab#9ab#ccd#ccd#ccd#ccd#9ab#9ab#9ab#9ab#9ab#000#000#000#ccd#ccd#ccd#ccd#ccd#ccd#eee#ccd#ccd#ccd#ccd#ccd#000#000#000#eee#eee#ccd#ccd#eee#eee#eee#000#eee#ccd#eee#eee#eee#000#000#000#000#000#000#000#000#000#000#000#000#000#000#000#000
#000#000#000#000#000#000#000#eee#eee#eee#eee#eee#eee#eee#000#000#000#000#000#eee#eee#eee#000#000#ccd#ccd#ccd#000#000#000#000#000#000#000#000#000#000#000#000#000#000#000#000#000#000#ccd#ccd#ccd#ccd#9ab#9ab#000#000#000#000#000#000#ccd#ccd#ccd#ccd#ccd#ccd#ccd#ccd#ccd#ccd#ccd#ccd#000#000#eee#eee#eee#ccd#9ab#ccd#ccd#000#000#000#ccd#ccd#eee#eee#000#000#eee#eee#eee#000#000#000#000#000#000#000#000#000#000#000
#000#000#000#000#eee#eee#eee#eee#eee#ccd#ccd#ccd#ccd#ccd#9ab#000#eee#eee#eee#ccd#ccd#ccd#ccd#000#ccd#ccd#ccd#000#000#000#000#000#000#000#000#000#000#000#000#000#000#000#000#000#000#ccd#ccd#ccd#ccd#000#000#000#000#000#000#000#000#ccd#ccd#ccd#ccd#ccd#ccd#ccd#ccd#ccd#ccd#ccd#ccd#000#000#ccd#ccd#ccd#9ab#000#ccd#ccd#ccd#000#000#ccd#ccd#ccd#ccd#000#eee#ccd#ccd#ccd#000#eee#000#000#000#000#000#eee#eee#000#000
#000#000#000#000#eee#eee#eee#eee#eee#ccd#ccd#ccd#ccd#ccd#9ab#000#eee#eee#eee#ccd#ccd#ccd#ccd#000#ccd#ccd#ccd#000#000#000#000#000#000#000#000#000#000#000#000#000#000#000#000#000#000#ccd#ccd#ccd#ccd#000#000#000#000#000#000#000#000#ccd#ccd#ccd#ccd#ccd#ccd#ccd#ccd#ccd#ccd#ccd#ccd#000#000#ccd#ccd#ccd#9ab#000#ccd#ccd#ccd#000#000#ccd#ccd#ccd#ccd#000#eee#ccd#ccd#ccd#000#eee#000#000#000#000#000#eee#eee#000#000
#000#000#000#eee#eee#ccd#ccd#ccd#ccd#9ab#9ab#9ab#9ab#9ab#000#000#eee#eee#9ab#9ab#9ab#ccd#ccd#ccd#000#ccd#ccd#000#000#000#eee#eee#eee#eee#000#000#000#000#eee#eee#eee#eee#eee#000#000#ccd#ccd#ccd#ccd#000#000#000#000#000#000#000#000#ccd#ccd#ccd#ccd#ccd#ccd#ccd#ccd#ccd#ccd#ccd#ccd#000#000#ccd#ccd#ccd#000#000#000#ccd#ccd#ccd#000#ccd#ccd#ccd#ccd#9ab#9ab#9ab#9ab#ccd#000#ccd#000#000#000#000#000#eee#ccd#ccd#000
#000#000#eee#eee#eee#ccd#ccd#ccd#ccd#000#000#000#000#000#000#eee#9ab#9ab#000#000#000#ccd#ccd#ccd#000#ccd#ccd#000#000#9ab#9ab#ccd#eee#eee#eee#000#eee#eee#eee#eee#ccd#ccd#eee#eee#000#ccd#ccd#ccd#ccd#000#000#000#000#000#000#000#000#ccd#ccd#ccd#ccd#ccd#ccd#ccd#ccd#ccd#ccd#ccd#ccd#000#000#ccd#ccd#ccd#000#000#000#ccd#ccd#ccd#000#ccd#ccd#ccd#ccd#9ab#000#000#9ab#ccd#ccd#ccd#000#000#000#000#000#000#9ab#9ab#000
#000#000#eee#eee#ccd#ccd#ccd#ccd#ccd#ccd#eee#eee#000#000#eee#eee#000#000#000#000#000#eee#ccd#ccd#000#ccd#ccd#000#000#000#000#000#ccd#ccd#ccd#000#eee#ccd#ccd#ccd#ccd#ccd#9ab#9ab#000#ccd#ccd#ccd#ccd#000#000#000#000#000#000#000#000#ccd#ccd#ccd#000#9ab#9ab#ccd#9ab#000#ccd#ccd#ccd#000#000#ccd#ccd#ccd#ccd#000#000#ccd#ccd#ccd#000#ccd#ccd#ccd#ccd#ccd#000#000#000#eee#ccd#ccd#000#000#000#000#000#000#9ab#000#000
#000#000#000#ccd#ccd#ccd#ccd#ccd#ccd#ccd#ccd#eee#eee#000#eee#ccd#ccd#ccd#000#000#eee#ccd#ccd#ccd#000#ccd#ccd#000#000#000#000#000#ccd#ccd#ccd#000#ccd#ccd#ccd#ccd#9ab#9ab#9ab#000#000#ccd#ccd#ccd#ccd#000#000#000#000#000#000#000#000#ccd#ccd#ccd#000#000#000#9ab#000#000#ccd#ccd#ccd#000#ccd#ccd#ccd#ccd#ccd#eee#eee#ccd#ccd#ccd#000#ccd#ccd#ccd#ccd#ccd#000#000#000#eee#ccd#ccd#000#000#000#000#000#000#000#000#000
#000#000#000#000#000#000#000#ccd#ccd#ccd#ccd#ccd#eee#000#000#ccd#ccd#ccd#eee#eee#ccd#ccd#ccd#ccd#000#ccd#ccd#000#000#000#000#000#eee#ccd#000#000#ccd#ccd#ccd#ccd#000#000#000#000#000#ccd#ccd#ccd#ccd#000#000#000#000#000#000#000#000#ccd#ccd#ccd#ccd#000#000#9ab#000#ccd#ccd#ccd#ccd#000#ccd#ccd#ccd#ccd#ccd#ccd#ccd#ccd#ccd#ccd#000#ccd#ccd#ccd#ccd#ccd#ccd#eee#eee#ccd#9ab#9ab#000#000#000#000#000#000#000#000#000
#000#000#000#000#eee#eee#eee#ccd#ccd#ccd#ccd#ccd#ccd#eee#000#ccd#ccd#ccd#ccd#ccd#ccd#ccd#000#000#ccd#ccd#ccd#000#000#000#000#eee#ccd#ccd#000#000#ccd#ccd#ccd#ccd#000#000#000#000#000#9ab#ccd#ccd#9ab#000#000#000#000#000#000#000#000#ccd#ccd#ccd#ccd#000#000#000#ccd#ccd#ccd#ccd#000#ccd#ccd#ccd#ccd#ccd#ccd#000#ccd#ccd#ccd#ccd#000#ccd#ccd#ccd#ccd#9ab#ccd#ccd#9ab#9ab#9ab#000#000#000#000#000#000#000#000#000#000
#000#000#eee#eee#ccd#ccd#ccd#ccd#ccd#ccd#ccd#ccd#9ab#9ab#000#ccd#ccd#ccd#ccd#ccd#ccd#000#000#000#000#9ab#9ab#000#000#eee#eee#ccd#9ab#9ab#000#ccd#ccd#ccd#ccd#ccd#ccd#9ab#9ab#000#000#9ab#9ab#9ab#9ab#000#000#000#000#000#000#000#000#9ab#ccd#ccd#9ab#000#000#000#9ab#ccd#ccd#9ab#000#ccd#ccd#ccd#ccd#ccd#9ab#000#ccd#9ab#9ab#9ab#000#ccd#ccd#ccd#ccd#9ab#9ab#9ab#9ab#9ab#000#000#000#000#000#000#000#000#000#000#000
#000#9ab#ccd#ccd#ccd#ccd#ccd#ccd#ccd#ccd#9ab#9ab#9ab#9ab#000#ccd#ccd#ccd#9ab#9ab#000#9ab#9ab#9ab#000#9ab#9ab#000#000#9ab#9ab#9ab#000#000#000#000#9ab#9ab#9ab#9ab#9ab#9ab#9ab#9ab#000#9ab#9ab#9ab#9ab#000#000#000#000#000#000#000#000#000#9ab#9ab#9ab#000#000#000#9ab#9ab#9ab#9ab#000#000#9ab#9ab#9ab#9ab#9ab#000#000#9ab#9ab#9ab#000#ccd#ccd#ccd#ccd#000#000#000#000#000#000#000#000#000#000#000#000#000#000#000#000
#000#9ab#ccd#ccd#ccd#ccd#ccd#ccd#ccd#ccd#9ab#9ab#9ab#9ab#000#ccd#ccd#ccd#9ab#9ab#000#9ab#9ab#9ab#000#9ab#9ab#000#000#9ab#9ab#9ab#000#000#000#000#9ab#9ab#9ab#9ab#9ab#9ab#9ab#9ab#000#9ab#9ab#9ab#9ab#000#000#000#000#000#000#000#000#000#9ab#9ab#9ab#000#000#000#9ab#9ab#9ab#9ab#000#000#9ab#9ab#9ab#9ab#9ab#000#000#9ab#9ab#9ab#000#ccd#ccd#ccd#ccd#000#000#000#000#000#000#000#000#000#000#000#000#000#000#000#000
#000#9ab#9ab#000#9ab#9ab#9ab#9ab#9ab#9ab#9ab#9ab#9ab#000#9ab#9ab#9ab#9ab#9ab#9ab#9ab#9ab#9ab#9ab#000#9ab#000#000#000#9ab#9ab#000#000#000#000#000#9ab#000#9ab#9ab#9ab#9ab#9ab#9ab#000#000#9ab#000#9ab#000#000#000#000#000#000#000#000#000#9ab#000#9ab#000#000#000#9ab#000#9ab#000#000#000#9ab#9ab#000#000#9ab#000#000#9ab#000#9ab#000#ccd#ccd#ccd#ccd#000#000#000#000#000#000#000#000#000#000#000#000#eee#000#000#000
#000#9ab#9ab#000#000#9ab#9ab#9ab#000#000#9ab#9ab#000#000#9ab#9ab#9ab#9ab#000#9ab#9ab#000#000#000#000#9ab#000#000#000#9ab#9ab#9ab#9ab#9ab#000#000#000#000#9ab#9ab#9ab#9ab#000#9ab#000#000#9ab#000#000#000#000#000#000#000#000#000#000#000#9ab#000#000#000#000#000#000#000#9ab#000#000#000#9ab#9ab#000#000#000#000#000#000#000#000#000#9ab#ccd#9ab#9ab#000#000#000#000#000#000#000#000#000#000#000#000#eee#9ab#000#000
#000#000#9ab#9ab#000#9ab#9ab#9ab#000#9ab#000#000#000#000#000#000#9ab#9ab#9ab#000#000#000#000#000#000#000#000#000#000#000#9ab#000#9ab#9ab#000#000#000#000#000#000#000#000#000#000#000#000#000#000#000#000#000#000#000#000#000#000#000#000#000#000#000#000#000#000#000#000#000#000#000#000#000#000#000#000#000#000#000#000#000#000#000#9ab#9ab#9ab#9ab#000#000#000#000#000#000#000#000#000#000#000#000#000#9ab#000#000
#000#000#000#000#000#000#000#000#000#000#000#000#000#000#000#000#000#000#000#000#000#000#000#000#000#000#000#000#000#000#000#000#000#000#000#000#000#000#000#000#000#000#000#000#000#000#000#000#000#000#000#000#000#000#000#000#000#000#000#000#000#000#000#000#000#000#000#000#000#000#000#000#000#000#000#000#000#000#000#000#000#9ab#9ab#9ab#9ab#000#000#000#000#000#000#000#000#000#000#000#000#000#000#000#000
#000#000#000#000#000#000#000#000#000#000#000#000#000#000#000#000#000#000#000#000#000#000#000#000#000#000#000#000#000#000#000#000#000#000#000#000#000#000#000#000#000#000#000#000#000#000#000#000#000#000#000#000#000#000#000#000#000#000#000#000#000#000#000#000#000#000#000#000#000#000#000#000#000#000#000#000#000#000#000#000#000#9ab#000#9ab#9ab#000#000#000#000#000#000#000#000#000#000#000#000#000#000#000#000
#000#000#000#000#000#000#000#000#000#000#000#000#000#000#000#000#000#000#000#000#000#000#000#000#000#000#000#000#000#000#000#000#000#000#000#000#000#000#000#000#000#000#000#000#000#000#000#000#000#000#000#000#000#000#000#000#000#000#000#000#000#000#000#000#000#000#000#000#000#000#000#000#000#000#000#000#000#000#000#000#000#9ab#000#000#000#000#000#000#000#000#000#000#000#000#000#000#000#000#000#000#000
